16 16
4 4 4 4 4 4 4 4 4 4 4 4 4 4 4 4
4 1 1 1 1 1 1 1 1 1 1 1 1 1 1 4
4 1 1 4 4 1 1 1 1 1 1 4 4 1 1 4
4 1 1 4 4 1 1 1 1 1 1 4 4 1 1 4
4 1 1 1 1 1 1 1 1 1 1 1 1 1 1 4
4 1 1 1 1 1 1 4 4 1 1 1 1 1 1 4
4 1 1 1 1 1 1 4 4 1 1 1 1 1 1 4
4 1 1 1 1 1 1 1 1 1 1 1 1 1 1 4
4 1 1 4 4 1 1 1 1 1 1 4 4 1 1 4
4 1 1 4 4 1 1 1 1 1 1 4 4 1 1 4
4 1 1 1 1 1 1 1 1 1 1 1 1 1 1 4
4 4 4 4 4 4 4 4 4 4 4 4 4 4 4 4
4 4 4 4 4 4 4 4 4 4 4 4 4 4 4 4
4 4 4 4 4 4 4 4 4 4 4 4 4 4 4 4
4 4 4 4 4 4 4 4 4 4 4 4 4 4 4 4


// 0 Solo [PRETO]
// 1 Grama [Verde]
// 2 Agua [azul]
// 3 Larva [red]
// 4 Pedra [cinza]